{
  "0": "０",
  "1": "１",
  "2": "２",
  "3": "３",
  "4": "４",
  "5": "５",
  "6": "６",
  "7": "７",
  "8": "８",
  "9": "９",
  "10": "あ",
  "11": "い",
  "12": "う",
  "13": "え",
  "14": "お",
  "15": "か",
  "16": "き",
  "17": "く",
  "18": "け",
  "19": "こ",
  "20": "さ",
  "21": "し",
  "22": "す",
  "23": "せ",
  "24": "そ",
  "25": "た",
  "26": "ち",
  "27": "つ",
  "28": "て",
  "29": "と",
  "30": "な",
  "31": "に",
  "32": "ぬ",
  "33": "ね",
  "34": "の",
  "35": "は",
  "36": "ひ",
  "37": "ふ",
  "38": "へ",
  "39": "ほ",
  "40": "ま",
  "41": "み",
  "42": "む",
  "43": "め",
  "44": "も",
  "45": "や",
  "46": "ゆ",
  "47": "よ",
  "48": "ら",
  "49": "り",
  "50": "る",
  "51": "れ",
  "52": "ろ",
  "53": "わ",
  "54": "を",
  "55": "ん",
  "56": "ア",
  "57": "イ",
  "58": "ウ",
  "59": "エ",
  "60": "オ",
  "61": "カ",
  "62": "キ",
  "63": "ク",
  "64": "ケ",
  "65": "コ",
  "66": "サ",
  "67": "シ",
  "68": "ス",
  "69": "セ",
  "70": "ソ",
  "71": "タ",
  "72": "チ",
  "73": "ツ",
  "74": "テ",
  "75": "ト",
  "76": "ナ",
  "77": "ニ",
  "78": "ヌ",
  "79": "ネ",
  "80": "ノ",
  "81": "ハ",
  "82": "ヒ",
  "83": "フ",
  "84": "へ",
  "85": "ホ",
  "86": "マ",
  "87": "ミ",
  "88": "ム",
  "89": "メ",
  "90": "モ"
}